1111111111
12       1
1        1
11111 1111
1        1
1  1     1
1  11111 1
1  1     1
1  1    31
1111111111
